IIIIIIIIIIIIIIIIIIIIIIIIIIIII--------------------------------------------------------------------------------------------------------------------------------------------------
I---------------------------I--------------------------------------------------------------------------------------------------------------------------------------------------
I----1---------------1------I--------------------------------------------------------------------------------------------------------------------------------------------------
IPPPPPPP-------PPPPPPP--PPPPI--------------------------------------------------------------------------------------------------------------------------------------------------
I---------------------------I--------------------------------------------------------------------------------------------------------------------------------------------------
I----PPPPPPPPPPPP-----------I--------------------------------------------------------------------------------------------------------------------------------------------------
I------------------------------------------------------------------------------------------------------------------------------------------------------------------------------
ILLLLLLLLLLLLLLLLLLLLLLLLLLLLGGGGGGGGGGGGGGGGGGGGGGGGGGGGGGGGGGGGGNNNNNNNNNNNNNNNNNNNNNNNNNNNNNNNNNNNNNNNNNNNNNNNNNNNNNNNNNNNNNNNNNNNNNNNNNNNNNNNNNNNNNNNNNNNNNNNNNNNNNNNNNNNNN