WWWWWWWWWWWWWWWWWWWWWWWWWWWWW--------------------------------------------------------------------------------------------------------------------------------------------------
W---------------------------W--------------------------------------------------------------------------------------------------------------------------------------------------
W------------------------------------------------------------------------------------------------------------------------------------------------------------------------------
W----1---------------1------W--------------------------------------------------------------------------------------------------------------------------------------------------
WPPPPPPP-------PPPPPPP--PPPPW--------------------------------------------------------------------------------------------------------------------------------------------------
W---------------------------W--------------------------------------------------------------------------------------------------------------------------------------------------
W------------------------------------------------------------------------------------------------------------------------------------------------------------------------------
W----PPPPPPPPPPPP-----------W--------------------------------------------------------------------------------------------------------------------------------------------------
W------------------------------------------------------------------------------------------------------------------------------------------------------------------------------
W------------------------------------------------------------------------------------------------------------------------------------------------------------------------------
GGGGGGGGGGGGGGGGGGGGGGGGGGGGGGGGGGGGGGGGGGGGGGGGGGGGGGGGGGGGGGGGGGGGGGGGGGGGGGGGGGGGGGGGGGGGGGGGGGGGGGGGGGGGGGGGGGGGGGGGGGGGGGGGGGGGGGGGGGGGGGGGGGGGGGGGGGGGGGGGGGGGGGGGGGGGGGG