(((((((((((((((((((((((((((((((((((((((((---------------------------------------------------------------------------------------------------------
(((((((((((((((((((((((((((((((((((((((((---------------------------------------------------------------------------------------------------------
(((((((((((((((((((((((((((((((((((((((((---------------------------------------------------------------------------------------------------------
((((((((((((AAAAAAAAAAA((((((((((((((((-----------------------------------------------------------------------------------------------------------
(((((((((((p-----------*(((((((((((((((-----------------------------------------------------------------------------------------------------------
(((((((((((p-----------*(((((((((((((((-----------------------------------------------------------------------------------------------------------
(((((((((((p-----------*(((((((((((((((-----------------------------------------------------------------------------------------------------------
(((((((((((p-----------*(((((((((((((((-----------------------------------------------------------------------------------------------------------
(((((((((((p-----------*(((((((((((((((-----------------------------------------------------------------------------------------------------------
(((((((((((p-----------*(((((((((((((((-----------------------------------------------------------------------------------------------------------
(((((((((((p-----------*(((((((((((((((-----------------------------------------------------------------------------------------------------------
((((((((((((NNN--NNNNNN(((((((((((((((/-----------------------------------------------------------------------------------------------------------
((((((((((((((B--BBBBBBBBBBBBBBBBBBBBBB(/---------------------------------------------------------------------------------------------------------
(((((((((((((H-------------------------G/---------------------------------------------------------------------------------------------------------
(((((((((((((H-------------------------G/---------------------------------------------------------------------------------------------------------
(((((((((((((H]}-----------------------G/---------------------------------------------------------------------------------------------------------
(((((((((((((H-------------------------G/---------------------------------------------------------------------------------------------------------
(((((((((((((H-------------------------G/---------------------------------------------------------------------------------------------------------
(((((((((((((H-------------------------G/---------------------------------------------------------------------------------------------------------
((((((((((((((MMMMMO-------------------G/---------------------------------------------------------------------------------------------------------
((((((((((((((((((((MMMMMMMMMMMMMMMMM--G/---------------------------------------------------------------------------------------------------------
((((((((((BBBBBBBBBBBBBBBBBBBBB(AAAAA--*/---------------------------------------------------------------------------------------------------------
(((((((((H---------------------=-------$----------------------------------------------------------------------------------------------------------
(((((((((H---------------------=-------$----------------------------------------------------------------------------------------------------------
(((((((((H---------------------=-----§*/)--------------------------------------------------------------------------------------------------------
(((((((((H---------------------=-------*/---------------------------------------------------------------------------------------------------------
(((((((((H---------------------=-------*/--------------------IJ-----------IJ----------------------------------------------------------------------
(((((((((H-----------------------------*/--------------------IJ-----------IJ----------------------------------------------------------------------
(((((((((H------------------------YZ&--*/--------------------IJ-----------IJ----------------------------------------------------------------------
(((((((((H-----MMMMMMMMMMMMMMMMMNNNNNNN(/--------------------IJ-----------IJ----------------------------------------------------------------------
((((((BBBB-----((BBBBBBBBBBBBBBBBBBBBBB(/--------------------IJ-----------IJ----------------------------------------------------------------------
(((((H---------(H----------------------G/--------------------IJ-----------IJ----------------------------------------------------------------------
(((((H-------]}BB----------------------G/--------------------IJ-----------IJ----------------------------------------------------------------------
(((((H---------------------------------G/--------------------IJ-----------IJ-------------------------------+@?@?@?!-------------------------------
(((((H---------------------------------G/--------------------IJ-----------IJ----------------------------------------------------------------------
(((((HVVVW-----------------------------G/--------------------IJ-----------IJ--------------------------------------------------------------bbFbFbFb
(((((H-------------------------------------------------------IJ-----------IJ--------------------------------------------------------------|------b
(((((H-------------------------------------------------------IJ-----------IJ-------------------------+@?@?@!------+@?@?@!-------------FbFb%------F
(((((H---------------------------------G/)-------------------IJ-----------IJ------------------------------------------------------------d--------b
(((((H---VVV---------------------------G/-----------------------------------------------------------------------------------------------{--------F
(((((H---XXX---------------------------G/-----------------------------------------------------------------------------------------------[--------b
((((((MMMMMMMMMMMMO--------------------G/--------QPPPPPPPPPPP~~~~~~~~~~~~~~~TUTUTUTUTUTUTUTUTUTTUTUTUTUTUTUTUTUTUTUTUTUTUTUTUTUTUTUTUTUTUTUTUTUTUT
(((((((((((((((((((MMMMMMMMMMMMMMMMMMMM((PPPPPPPP((((((((((((aaaaaaaaaaaaaaabbbbbbbbbbbbbbbbbbbbbbbbbbbbbbbbbbbbbbbbbbbbbbbbbbbbbbbbbbbbbbbbbbbbbb
(((((((((((((((((((((((((((((((((((((((((((((((((((((((((((((aaaaaaaaaaaaaaabbbbbbbbbbbbbbbbbbbbbbbbbbbbbbbbbbbbbbbbbbbbbbbbbbbbbbbbbbbbbbbbbbbbbb